############################################################.
############################################################.
##########..##############***##>>>.................#########.
#####.....................***##>>>....................######.
####......................***##>>>.....................#####.
###.......................***##>>>......................####.
###.......................***##>>>......................####.
##........######..........***##>>>.......................###.
##.......#########........***##>>>.......................###.
##.......##########################################......###.
##.......###########################################.....###.
##......##########.........................#########.....###.
##......########............................########.....###.
##......########.............................#######.....###.
##.......######..............................######......###.
###......#####...........##############.......#####......###.
###........##..........#################......####.......###.
###..................###################......###........###.
####...............##########.......###.......##........####.
######...........###########.........#.......##........#####.
#########.....#############..................##.......######.
##########################..................##......########.
################...............####........##.......########.
#############.................######......###.......########.
###########...................#######....####.......########.
#########...................#################.......########.
########.........############################.......########.
#######........#####......###################.......########.
######........###...........########......###.......########.
#####........###.............######........##.......########.
#####.......###...............####..........##......########.
####.......###......####......####..........##......########.
####.......###....#######.....###...........###.....########.
####......###.....#######.....###...........###.....########.
####......###.....#######.....##.......#....###......#######.
####......####.....######.....##......###...###.......######.
####......######....#####.....#......####....##........#####.
####......#######....###.....##......###.....##.........####.
#####......######....###.....##......##.....####.........###.
#####.......###......##......#......###.....#######......###.
######..............###.....##......###......#######.....###.
#######.............##......#......####......#######....####.
########...........###......#......####......#######....####.
#########........#####.....##......####.......#####....#####.
###########.....#####......#......#####................#####.
#####################......#......#####...............######.
####################......##......######..............######.
###################.......##......###########........#######.
##################.......####.....############......########.
#################.......######.....#########################.
#################......#######......########################.
#################.....#########......#######################.
#################.....#########......#######################.
#################......########......#######################.
#################.......######......########################.
#################.........##.......#########################.
###################...............##########################.
####################.............###########################.
#####################..........#############################.
############################################################.
.............................................................
