############################################################
############################################################
##########..##############***##>>>.................#########
#####.....................***##>>>....................######
####......................***##>>>.....................#####
###.......................***##>>>......................####
###.......................***##>>>......................####
##........######..........***##>>>.......................###
##.......#########........***##>>>.......................###
##.......##########################################......###
##.......###########################################.....###
##......##########.........................#########.....###
##......########............................########.....###
##......########.............................#######.....###
##.......######..............................######......###
###......#####...........##############.......#####......###
###........##..........#################......####.......###
###..................###################......###........###
####...............####################.......##........####
######...........#####################.......##........#####
#########.....######################.........##.......######
###################################.........##......########
###################################................#########
####################################...............#########
#####################################............###########
############################################################
