####################################
####################################
##########...................******#
#######......................******#
#####........................******#
####.........................******#
###..........................******#
###..........................******#
##...........................******#
##............######################
##...........#######################
##........#..#######################
##.......##..#######################
##......###...######################
##......####..######################
##......####...###############..####
##.......####...###########.......##
###.......####...########.........##
###.........###....####...........##
####..............................##
#####.............................##
######............................##
########..........................##
######################............##
#####################...###.......##
###################....#####......##
####...............................#
###...............................##
##................................##
##................................##
#................................###
#.>..............................###
##.............................#####
###........................#########
####################################
####################################
